*#*#*##*#*#*##*#*#*##
#                   *
*                   #
*           S       #
*                   #
*                   #
*#*#*##*#*#*##*#*#*##