*#*#*##*#*#*##*#*#*##
#                   *
*                   #
*                   #
*                   #
*                   #
*                   #
*                   #
*                   #
*                   #
*                   #
*                   #
*                   #
*                   #
*                   #
*                  S#
*#*#*##*#*#*##*#*#*##