*#*#*##*#*#*##*#*#*##
#                   *
*  *                #
*  *  $     S       #
*  *                #
*                *  #
*#*#*##*#*#*##*#*#*##