*#*#*##*#*#*##*#*#*##
#                   *
* S                 #
*                   #
*                   #
*                   #
*#*#*##*#*#*##*#*#*##