*********************************
*S  *           *   *   *       *
*** * * ********* * *** * *******
* *   * *         *   *     *   *
* ***** ***** *** * ******* * ***
* * *     * * * * * *     *     *
* * * ***** *** * * * ******* ***
*   * *         * * *     *     *
*** * * * ***** *** * ********* *
* * *   * *     *         *   * *
* * ***** ***** * * ***** *** * *
*     *   * *     * * * * * *   *
*** ******* *** ***** * * * * * *
*     *   *   *   *     * *   * *
* * * *** * * * * * ******* * ***
* * * *     *   * *     * * *   *
*** * *********** ***** * * *****
*   *   * *   *   * * * * *   * *
***** *** *** *** * * * * * *** *
*   *   *       *       * *     *
* * *** *** * ***** * * * * *** *
* * *     * *       * * *   *   *
* * * ******* ********* * * *** *
* * *   *     * *   * *   * *   *
* *** * * * * * *** * * *** * ***
*     *   * *     *     * * * * *
* *** * *** * * *** *** * * *** *
*   * * *   * * *   * *   *     *
********* ******* *** * *** *** *
*       *   *         * *   *   *
*** * * * * ***** ********* *** *
*   * *   *     * *           *$*
*********************************